Code	SeniorCollector_nom	SeniorCollector_prenom	SeniorCollector	Code2
AAF	Andriamanantena	Flavien Antonio	Andriamanantena, Flavien Antonio	
AF	Andriatsiferana	Félix	Andriatsiferana, Félix	
AFJ	Adamainty	Jean-Florent	Adamainty, Jean-Florent	
AFW	Westerhaus	Andoni F.	Westerhaus, Andoni F.	
AJL	Andriantiana	Jacky Lucien	Andriantiana, Jacky Lucien	
ALA	Ambalabe	Shade House	Ambalabe, Shade House	
ALBO	Andriamaharoa 	Hubert	Andriamaharoa, Hubert	
ALD	Andriamahefarivo	Lalao	Andriamahefarivo, Lalao	
ALH	Lehavana	Adolphe	Lehavana, Adolphe	
ALR	Andriamiarisoa	Lala Roger	Andriamiarisoa, Lala Roger	
AM	Andrianarisata	Michèle	Andrianarisata, Michèle	
AMA	Atalahy	Anselme Marcel	Atalahy, Anselme Marcel	
AMB	Ambatovy	Shade House	Ambatovy, Shade House	
AMR	Ramahefaharivelo	Ando Malala	Ramahefaharivelo, Ando Malala	
ANM	Andrianjafy	Naina Mamisoa	Andrianjafy, Naina Mamisoa	
ANS	Andriamiadana	Stéphano	Andriamiadana, Stéphano	
ANT	Antananarivo	Shade House	Antananarivo, Shade House	
AP	Antilahimena	Patrice	Antilahimena, Patrice	
ARF	Andriamparany	Rivolala Fanomezantsoa	Andriamparany, Rivolala Fanomezantsoa	
ASH	Andriantsalohimisantatra	Andon'ny Avo Hermin Euléandrah	Andriantsalohimisantatra, Andon'ny Avo Hermin Euléandrah	
ASR	Andriambololonera	Sylvie	Andriambololonera, Sylvie	
ATH	Andriamihajarivo	Tefy Harison	Andriamihajarivo, Tefy Harison	
ATJ	Andonahary	Tahinarivony Jacquis	Andonahary, Tahinarivony Jacquis	
ATR	Rabefarihy	Andriantsoa Tahiry	Rabefarihy, Andriantsoa Tahiry	
BD	Berry	Paul	Berry, Paul	
BEN	Rakotonirina	Benja	Rakotonirina, Benja	
BFL	Rakotozafy 	Brice Funk Lee 	Rakotozafy, Brice Funk Lee 	
BHL	Bemita	Harson Landry	Bemita, Harson Landry	
BHV	Behevitra	Laurent	Behevitra, Laurent	
BJT	Be	Jullet	Be, Jullet	
BL	Lewis	Beverley	Lewis, Beverley	
BM	Randriambololona	Michel Bien-Aimé	Randriambololona, Michel Bien-Aimé	
CB	Birkinshaw	Christopher	Birkinshaw, Christopher Robert	
CB	Birkinshaw	Christopher	Birkinshaw, Christopher	
CCL	Claude	Christian	Claude, Christian	
CHW	Hong Wa	Cynthia	Hong Wa, Cynthia	
CKS	Skema 	Cindy	Skema, Cindy	
CLF	Frasier	Cynthia	Frasier, Cynthia	
CR	Rakotovao	Charles	Rakotovao, Charles	
D	Daly	Douglas	Daly, Douglas	
DB	Baum	David 	Baum, David 	
DRD	Andriamiarimanana	Donatien	Andriamiarimanana, Donatien	
EME	Emeline		Emeline	
FAR	Rajaonary	Fano A.	Rajaonary, Fano A.	
FERM	Ferm	Julia	Ferm, Julia	
FLN	Faliniaina	Lucien	Faliniaina, Lucien	
FMB	Randriantafika	Faly	Randriantafika, Faly	
FRB	Faranirina	Lantoarisoa	Faranirina, Lantoarisoa	
GES	Schatz	George	Schatz, George	
GILLESPIE	Gillespie 	Lynn 	Gillespie, Lynn 	
GM	Mathieu	Guido	Mathieu, Guido	
GM	Rahajasoa	Grace Monique	Rahajasoa, Grace Monique	
GRV	Gervais		Gervais	
GTR	Guittou	Riri	Guittou, Riri	
HNR	Andriamiarinoro	Honoré	Andriamiarinoro, Honoré	
HRS	Ravaomanalina	Bako Harisoa	Ravaomanalina, Bako Harisoa	
HS	Sauquet	Hervé	Sauquet, Hervé	
HSC	Hery (?)	Soanary Claude	Hery (?), Soanary Claude	
IB	Iambana	Bernard	Iambana, Bernard	
IL	Luino	Iacopo	Luino, Iacopo	
J	Raharilala	Jeannine	Raharilala, Jeannine	
JA	Aridy	Jao	Aridy, Jao	
JCB	Bradford	Jason C.	Bradford, Jason C.	
JFR	Razafitsalama	Lalao Jeremi	Razafitsalama, Lalao Jeremi	RLJ
JFR	Razafitsalama	Lalao Jeremi	Razafitsalama, Jérémie Lalao	
JJM	Morawetz	Jeffery	Morawetz, Jeffery	
JJW	Tombonirina	Jean Jacques Wira	Tombonirina, Jean Jacques Wira	
JL	Mora	Jean-Luc	Mora, Jean-Luc	
JM	Miller	Jim	Miller, Jim	
JNI	Raharimampionona	Jeannie	Raharimampionona, Jeannie	
JTA	Josso Tianarifidy 	Angelos Stanislas	Josso Tianarifidy, Angelos Stanislas	
KA	Kotozafy	Alphonse	Kotozafy, Alphonse	
KAD	Karatra	Aimé Dochard	Karatra, Aimé Dochard	
KAD	Karatra	Aimée Dochard	Karatra, Aimée Dochard	
LAIVAO	Laivao	Michel Omer	Laivao, Michel Omer	
LG	Gautier	Laurent Vincent	Gautier, Laurent Vincent	
LG	Gautier	Laurent	Gautier, Laurent	
LN	Lachezar	Nikolov	Lachezar, Nikolov	
LPB	Leopold	Jean Berthieu	Leopold, Jean Berthieu	
LR	Laha	Rolland	Laha, Rolland	
LRK	Letsara 	Rockiman	Letsara, Rockiman	
LRZ	Ludovic	Reza	Ludovic, Reza	
LV	Vary	Laura	Vary, Laura	
MAE	Ratolojanahary	Maherisoa	Ratolojanahary, Maherisoa	
MAR	Rabarimanarivo	Marina	Rabarimanarivo, Marina	
MC	Callmander	Martin	Callmander, Martin	
MCP	McPherson	Gordon	McPherson, Gordon	
MER	Rahelivololona	Marie Elisette	Rahelivololona, Marie Elisette	
MIC	Miandrimanana	Cyprien	Miandrimanana, Cyprien	
MM	Moeller	Michael	Moeller, Michael	
MNH	Manjakahery	Herisoa Nantena	Manjakahery, Herisoa Nantena	
MNV	Manjato	Nadiah Vololomboahangy	Manjato, Nadiah Vololomboahangy	
MR	Martial		Martial	
MZ	Zjhra	Michelle	Zjhra, Michelle	
NAT	Ramanantenasoa	Nantenaina	Ramanantenasoa, Nantenaina	
NH	Helme	Nick	Helme, Nick	
NM	Messmer	Nathalie	Messmer, Nathalie	
NMR	NA	NA	NA	
NSR	Rasoanaivo 	Niry	Rasoanaivo, Niry	
NW	Wilding	Nicholas	Wilding, Nicholas	
NZM	Nombanjanahary	Zoherinjina Minosoa	Nombanjanahary, Zoherinjina Minosoa	
OA	Andrianantoanina	Olivier	Andrianantoanina, Olivier	
OP	Odile	Poncy	Odile, Poncy	
PBP	Phillipson	Peter B.	Phillipson, Peter B.	
PDB	De Block	Petra	De Block, Petra	
PJ	Rakotomalaza	Pierre Jules	Rakotomalaza, Pierre Jules	
PPL	Lowry	Pete	Lowry, Pete	
PR	Ranirison	Patrick	Ranirison, Patrick	
R	Rabevohitra	Raymond	Rabevohitra, Raymond	
RA	Randrianasolo	Armand	Randrianasolo, Armand	
RAB	Rabearivony	Dimbilala Aina Nomenjanahary	Rabearivony, Dimbilala Aina Nomenjanahary	
RAD	Rabehevitra	David	Rabehevitra, David	
RAF	Rakotoarisoa	Fenonirina	Rakotoarisoa, Fenonirina	
RAG	Rakotonirina	Arsène Giovanni	Rakotonirina, Arsène Giovanni	
RAL	Ravelomalala	Lucia Stefanie	Ravelomalala, Lucia Stefanie	
RAL	Ravelomalala	Lucia S.	Ravelomalala, Lucia S.	
RAM	Razafimalala	Andrée Anne Marie	Razafimalala, Andrée Anne Marie	
RAV	Ravaoherinavalona	Rota	Ravaoherinavalona, Rota	
RB	Ramamonjiarisoa	Bakolimalala	Ramamonjiarisoa, Bakolimalala	
RB	Randriamampionona	Bébéronn	Randriamampionona, Bébéronn	
RBC	Razafindrazaka	Barthelemi	Razafindrazaka, Barthelemi	
RBE	Bernard	Roger	Bernard, Roger	
RBM	Ralaijaona	Benjamina	Ralaijaona, Benjamina	
RBO	Rakotonindriana 	Bruno	Rakotonindriana, Bruno	
RBR	Ramandimbisoa	Brigitte	Ramandimbisoa, Brigitte	
RBU	Bussmann	Rainer	Bussmann, Rainer	
RCN	Rado Claudio	Nandrasana	Rado Claudio, Nandrasana	
RCS	Randrianarivelo	Clairemont	Randrianarivelo, Clairemont	
RD	Ravelonarivo	Désiré	Ravelonarivo, Désiré	
RDG	Randriamahazomanana	Daniel George	Randriamahazomanana, Daniel George	
RDN	Ravelomanantsoa	Daniel	Ravelomanantsoa, Daniel	
RED	Ramisy	Edmond	Ramisy, Edmond	
REH	Razanatsoa	Hélène	Razanatsoa, Hélène	
RER	Raharijaona	Era Riana	Raharijaona, Era Riana	
RF	Rasoavimbahoaka	Fanjanavalona	Rasoavimbahoaka, Fanjanavalona	
RFA	Ratovoson	Fidisoa	"Ratovoson, Fidisoa ""Fidy"""	
RFA	Ratovoson	Fidisoa	Ratovoson, Fidisoa	
RFM	Randriatsivery	Floria Monique	Randriatsivery, Floria Monique	
RFM	Randriatsivery	Monique Fleuria	Randriatsivery, Monique Fleuria	
RFN	Ramanitrinizaka	Fanilo 	Ramanitrinizaka, Fanilo Malala	
RFN	Ramanitrinizaka	Fanilo 	Ramanitrinizaka, Fanilo 	
RFY	Razafindrakoto	Fanjambola Yolande	Razafindrakoto, Fanjambola Yolande	
RHA	Archer	Robert H.	Archer, Robert H.	
RHA	Rasolohery	Andriambolantsoa	Rasolohery, Andriambolantsoa	
RHF	Razafimelison	Herivola Fenitriniela	Razafimelison, Herivola Fenitriniela	
RHJ	Rasoazanany	Haingo Marie Judith	Rasoazanany, Haingo Marie Judith	
RHM	Ramanambohitra	Herinambinina Navalona	Ramanambohitra, Navalona Herinambinina	
RHM	Ramanambohitra	Herinambinina Navalona	Ramanambohitra, Herinambinina Navalona	
RHN	Ravololonanahary	Hantanirina	Ravololonanahary, Hantanirina	
RHS	Ranarivelo	Heritiana	Ranarivelo, Heritiana	
RHS	Ratsaralaza	Herisitraka	Ratsaralaza, Herisitraka	
RHT	Rasatatsihoarana	Thierry H.F.	Rasatatsihoarana, Thierry H.F.	
RHV	Razafindraibe	Hanta	Razafindraibe, Hanta	
RIR	Randrianaivo	Richard	Randrianaivo, Richard	
RJ	Randrianasolo	Joma	Randrianasolo, Joma	
RJ	Roilahy	Justin	Roilahy, Justin	
RJA	Ramahenina	Joharintsoa Aina	Ramahenina, Joharintsoa Aina	
RJB	Razafindrabe	Jean-Baptiste	Razafindrabe, Jean-Baptiste	
RJH	Ramahefarison	Jacquis Harimbolasoa	Ramahefarison, Jacquis Harimbolasoa	
RJL	Randriamanarivo	Juliette	Randriamanarivo, Juliette	
RJO	Rabenantoandro	Johny	Rabenantoandro, Johny	
RJQ	Razanatsoa	Jacqueline	Razanatsoa, Jacqueline	
RJS	Rajaonary	Stanislas	Rajaonary, Stanislas	
RJU	Rabe	Justin	Rabe, Justin	
RKM	Rabe	Koloina Manohisoa	Rabe, Koloina Manohisoa	
RKN	Rakotoarivelo	Nivo Hariniaina	Rakotoarivelo, Nivo Hariniaina	
RKN	Rakotoarivelo	Nivo Hariniaina	Rakotoarivelo, Nivo H.	
RL	Rakotomalala	Liva	Rakotomalala, Liva	
RLC	Raholivelo	Liliane Christine	Raholivelo, Liliane Christine	
RLI	Ralimanana	Hélène	Ralimanana, Hélène	
RLL	Rakotondrafara	Andriamalala	Rakotondrafara, Andriamalala	
RLM	Randrianjanaka	Lucien Marson	Randrianjanaka, Lucien Marson	
RLP	Rasoamanana	Lalaina Patricia	Rasoamanana, Lalaina P.	
RLP	Rasoamanana	Lalaina Patricia	Rasoamanana, Lalaina Patricia	
RMF	Ramanakoto	Miora Falimiarana	Ramanakoto, Miora Falimiarana	
RMF	Ramanakoto	Miora Falimiarana	Ramanakoto, Miora M.	same as Miora Falimiarana?
RMH	Rasoafaranaivo	Margianne Hariline	Rasoafaranaivo, Margianne Hariline	
RMN	Razafindraibe	Nambinintsoa Mendrika	Razafindraibe, Nambinintsoa Mendrika	
RMO	Randrianjanahary	Miramasoandro Onitiana	Randrianjanahary, Miramasoandro Onitiana	
RMS	Rasoanindriana	Mahenintsoa Harisandy	Rasoanindriana, Mahenintsoa Harisandy	
RN	Réserves Naturelles de Madagascar	Réserves Naturelles de Madagascar	RESERVES NATURELLES, *	
RN	Réserves Naturelles de Madagascar	Réserves Naturelles de Madagascar	Reserves Naturelles [collection series]	
RNA	Razafimamonjy	Nivo Alisoa	Razafimamonjy, Nivo ALisoa	
RNA	Razafimamonjy	Nivo Alisoa	Razafimamonjy, Nivo Alisoa	
RNF	Rakotonasolo	Franck	Rakotonasolo, Franck	
RNH	Rakotonirina	Nivohenintsoa	Rakotonirina, Nivohenintsoa	
ROC	Randriambololomamonjy	Ornella Christine	Randriambololomamonjy, Ornella Christine	
ROL	Rakotondrajaona	Roland	Rakotondrajaona, Roland	
ROM	Rabarijaona	Narindra Romer	Rabarijaona, Narindra Romer	
RON	Rafanomezantsoa	Odoris Norlin	Rafanomezantsoa, Odoris Norlin	
ROR	Ranaivojaona	Rolland	Ranaivojaona, Rolland	
ROZ	Randimbison	Maherizo	Randimbison, Maherizo	
RPJ	Randria	Paul Joseph	Randria, Paul Joseph	
RR	Rakoto	Raphael	Rakoto, Raphael	
RRA	Rajoharison	Rivo	Rajoharison, Rivo	
RRE	Randriamarosoa	Rémi	Randriamarosoa, Rémi	
RRG	Ramison	Roger Georgensen	Ramison, Roger Georgensen	
RRH	Ramananjanahary	Rondro	Ramananjanahary, Rondro	
RRI	Rajemisa	Richard	Rajemisa, Richard	
RRN	Ramanantsialonina	Ravo Nantenaina	Ramanantsialonina, Ravo Nantenaina	
RS	Rapanarivo	Solo	Rapanarivo, Solo	
RSE	Rakotoarisoa	Solofo Eric	Rakotoarisoa, Eric Solofo	
RSE	Rakotoarisoa	Solofo Eric	Rakotoarisoa, Solofo Eric	
RTF	Raveloson	Tolojanahary Felantsoa	Raveloson, Tolojanahary Felantsoa	
RTH	Rakouth	Hasina Nomentsoa	Rakouth, Hasina Nomentsoa	
RTN	Randriamiharisoa	Tolojanahary Nirina Maria	Randriamiharisoa, Tolojanahary Nirina Maria	
RTN	Tolojanahary	Nirina	Tolojanahary, Nirina	
RTV	Rivoharison	Tahiry Victoria	Rivoharison, Tahiry Victoria	
RVF	Ravelonahina	Harimisa 	Ravelonahina, Harimisa 	
RVM	Rasolofoniaina	Vonimirana Mbolatiana	Rasolofoniaina, Vonimirana Mbolatiana	
RVN	Ravololomanana	Noromalala	Ravololomanana, Noromalala	
RVO	Andrianasolo	Rivoniony	Andrianasolo, Rivoniony	
RVT	Razafindrahaja	Vololotahina	Razafindrahaja, Vololotahina	
RZA	Razanatsima	Aina	Razanatsima, Aina	
RZC	Rakotonirina	Casmir	Rakotonirina, Casmir Zoly	
RZC	Rakotonirina	Casmir	Rakotonirina, Casmir	
RZD	Razafindramora	Dernah	Razafindramora, Dernah	
RZK	Razakamalala	Richardson	Razakamalala, Richardson	
RZK	Razakamalala	Richard	Razakamalala, Richard	
SAF	Andrianarivelo	Sandratra Aina Fanantenana	Andrianarivelo, Sandratra Aina Fanantenana	
SAN	Sandratriniaina	Andrianasolo Ninah	Sandratriniaina, Andrianasolo Ninah	
SB	Buerki	Sven	Buerki, Sven	
SBF	Federman	Sarah Beck	Federman, Sarah Beck	
SC	Crameri	Simon Flavio	Crameri, Simon Flavio	
SF	Service Forestier de Madagascar	Service Forestier de Madagascar	Service Forestier de Madagascar	
SF	Service Forestier de Madagascar	Service Forestier de Madagascar	Service forestier [collection series]	
SF	Service Forestier de Madagascar	Service Forestier de Madagascar	SERVICE FORESTIER, *	
SFR	Andrianarivelo	Soafara	Andrianarivelo, Soafara Niaina	
SFR	Andrianarivelo	Soafara	Andrianarivelo, Soafara	
SG	Razafimandimbison	Sylvain Georges	Razafimandimbison, Sylvain Georges	
SH	Hassold	Sonja	Hassold, Sonja	HS
SJ	Solo	Justin	Solo, Justin	
SM	Malcomber	Simon	Malcomber, Simon	
SNGF	Silo National des Graines Forestières	Silo National des Graines Forestières	SNGF	
SRA	Syde 	Rémi Anthony	Syde, Anthony Rémi	
SRA	Syde 	Rémi Anthony	Syde, Rémi Anthony	
SSR	Randrianasolo	Sennen Solofo	Randrianasolo, Sennen Solofo	
ST	Rakotonandrasana	Stephan	Rakotonandrasana, Stephan	
SV	Verlynde	Simon 	Verlynde, Simon 	
SW	Wohlhauser	Sébastian	Wohlhauser, Sébastian	
SY	Eboroke	Sylvin	Eboroke, Sylvin	
TAB	Randrianarivony	Tabita	Randrianarivony, Tabita	
TAJ	Tahinarivony	Andonahary  Jacquis 	Tahinarivony, Andonahary  Jacquis 	
TDD	Tahirinirainy	Dinasoa Donné	Tahirinirainy, Dinasoa Donné	
TH	Haevermans	Thomas	Haevermans, Thomas	
TOK	Ralainaorina	Toky Niaina	Ralainaorina, Toky Niaina	
TS	Stevart	Tariq	Stevart, Tariq	
TSS	Tsarasoa	Sitrakiniaina Sandy	Tsarasoa, Sitrakiniaina Sandy	
WLA	Applequist	Wendy 	Applequist, Wendy 	
ZR	Rogers	Zachary Scott	Rogers, Zachary Scott	